{
  "name": "hotdox76-v2",
  "vendorProductId": 2862000809,
  "macros": ["", "", "", "", "", "", "", "", "", "", "", "", "", "", "", ""],
  "layers": [
    [
      "KC_NO",
      "KC_END",
      "KC_LALT",
      "MT(MOD_LGUI,KC_SPC)",
      "KC_HOME",
      "KC_MPRV",
      "KC_MNXT",
      "KC_LCTL",
      "KC_SPC",
      "KC_VOLD",
      "KC_VOLU",
      "KC_MPLY",
      "KC_NO",
      "KC_NO",
      "KC_LSFT",
      "KC_Z",
      "KC_X",
      "KC_C",
      "KC_V",
      "KC_B",
      "KC_RGHT",
      "KC_ESC",
      "KC_A",
      "KC_S",
      "KC_D",
      "KC_F",
      "KC_G",
      "KC_NO",
      "KC_TAB",
      "KC_Q",
      "KC_W",
      "KC_E",
      "KC_R",
      "KC_T",
      "KC_LEFT",
      "KC_GRV",
      "KC_1",
      "KC_2",
      "KC_3",
      "KC_4",
      "KC_5",
      "KC_LEFT",
      "KC_NO",
      "KC_PGDN",
      "KC_BSPC",
      "LT(1,KC_ENT)",
      "KC_PGUP",
      "KC_DEL",
      "RGB_TOG",
      "KC_RCTL",
      "KC_RBRC",
      "KC_LBRC",
      "KC_BSLS",
      "MO(1)",
      "KC_NO",
      "KC_NO",
      "KC_RSFT",
      "KC_SLSH",
      "KC_DOT",
      "KC_COMM",
      "KC_M",
      "KC_N",
      "KC_DOWN",
      "KC_QUOT",
      "KC_SCLN",
      "KC_L",
      "KC_K",
      "KC_J",
      "KC_H",
      "KC_NO",
      "KC_MINS",
      "KC_P",
      "KC_O",
      "KC_I",
      "KC_U",
      "KC_Y",
      "KC_UP",
      "KC_EQL",
      "KC_0",
      "KC_9",
      "KC_8",
      "KC_7",
      "KC_6",
      "TO(1)"
    ],
    [
      "KC_NO",
      "KC_TRNS",
      "RGB_VAI",
      "RGB_VAD",
      "KC_TRNS",
      "RGB_MOD",
      "KC_TRNS",
      "KC_TRNS",
      "KC_TRNS",
      "KC_TRNS",
      "KC_TRNS",
      "KC_TRNS",
      "KC_NO",
      "KC_NO",
      "KC_TRNS",
      "KC_MS_ACCEL0",
      "KC_MS_ACCEL1",
      "KC_MS_ACCEL2",
      "KC_TRNS",
      "KC_TRNS",
      "KC_TRNS",
      "KC_TRNS",
      "KC_MS_LEFT",
      "KC_MS_DOWN",
      "KC_MS_RIGHT",
      "KC_TRNS",
      "KC_GRV",
      "KC_NO",
      "KC_TRNS",
      "KC_MS_BTN1",
      "KC_MS_UP",
      "KC_MS_BTN2",
      "KC_TRNS",
      "KC_TRNS",
      "KC_TRNS",
      "KC_TRNS",
      "KC_F1",
      "KC_F2",
      "KC_F3",
      "KC_F4",
      "KC_F5",
      "KC_TRNS",
      "KC_NO",
      "KC_TRNS",
      "RGB_HUD",
      "RGB_HUI",
      "KC_TRNS",
      "KC_TRNS",
      "RGB_TOG",
      "KC_TRNS",
      "KC_EQL",
      "KC_0",
      "KC_PDOT",
      "KC_TRNS",
      "KC_NO",
      "KC_NO",
      "KC_TRNS",
      "KC_BSLS",
      "KC_3",
      "KC_2",
      "KC_1",
      "KC_TRNS",
      "KC_TRNS",
      "KC_SLEP",
      "S(KC_EQL)",
      "KC_MS_WH_RIGHT",
      "KC_MS_WH_UP",
      "KC_MS_WH_DOWN",
      "KC_MS_WH_LEFT",
      "KC_NO",
      "KC_F12",
      "S(KC_8)",
      "KC_9",
      "KC_8",
      "KC_7",
      "KC_TRNS",
      "KC_TRNS",
      "KC_F11",
      "KC_F10",
      "KC_F9",
      "KC_F8",
      "KC_F7",
      "KC_F6",
      "TO(0)"
    ],
    [
      "KC_NO",
      "KC_TRNS",
      "KC_TRNS",
      "KC_TRNS",
      "KC_TRNS",
      "KC_TRNS",
      "KC_TRNS",
      "KC_TRNS",
      "KC_TRNS",
      "KC_TRNS",
      "KC_MS_BTN1",
      "KC_MS_BTN2",
      "KC_NO",
      "KC_NO",
      "KC_TRNS",
      "KC_TRNS",
      "KC_TRNS",
      "KC_TRNS",
      "KC_TRNS",
      "KC_TRNS",
      "KC_TRNS",
      "KC_TRNS",
      "KC_TRNS",
      "KC_TRNS",
      "KC_TRNS",
      "KC_TRNS",
      "KC_TRNS",
      "KC_NO",
      "KC_TRNS",
      "KC_TRNS",
      "KC_TRNS",
      "KC_TRNS",
      "KC_TRNS",
      "KC_TRNS",
      "KC_TRNS",
      "KC_TRNS",
      "KC_TRNS",
      "KC_TRNS",
      "KC_TRNS",
      "KC_TRNS",
      "KC_TRNS",
      "KC_TRNS",
      "KC_NO",
      "KC_TRNS",
      "KC_TRNS",
      "KC_WWW_BACK",
      "KC_TRNS",
      "KC_TRNS",
      "KC_TRNS",
      "KC_TRNS",
      "KC_TRNS",
      "KC_MUTE",
      "KC_VOLD",
      "KC_VOLU",
      "KC_NO",
      "KC_NO",
      "KC_TRNS",
      "KC_TRNS",
      "KC_MNXT",
      "KC_MPRV",
      "KC_TRNS",
      "KC_TRNS",
      "KC_TRNS",
      "KC_MPLY",
      "KC_TRNS",
      "KC_TRNS",
      "KC_TRNS",
      "KC_TRNS",
      "KC_TRNS",
      "KC_NO",
      "KC_TRNS",
      "KC_TRNS",
      "KC_TRNS",
      "KC_TRNS",
      "KC_TRNS",
      "KC_TRNS",
      "KC_TRNS",
      "KC_TRNS",
      "KC_TRNS",
      "KC_TRNS",
      "KC_TRNS",
      "KC_TRNS",
      "KC_TRNS",
      "KC_TRNS"
    ],
    [
      "KC_NO",
      "KC_TRNS",
      "KC_TRNS",
      "KC_TRNS",
      "KC_TRNS",
      "KC_TRNS",
      "KC_TRNS",
      "KC_TRNS",
      "KC_TRNS",
      "KC_TRNS",
      "KC_TRNS",
      "KC_TRNS",
      "KC_NO",
      "KC_NO",
      "KC_TRNS",
      "KC_TRNS",
      "KC_TRNS",
      "KC_TRNS",
      "KC_TRNS",
      "KC_TRNS",
      "KC_TRNS",
      "KC_TRNS",
      "KC_TRNS",
      "KC_TRNS",
      "KC_TRNS",
      "KC_TRNS",
      "KC_TRNS",
      "KC_NO",
      "KC_TRNS",
      "KC_TRNS",
      "KC_TRNS",
      "KC_TRNS",
      "KC_TRNS",
      "KC_TRNS",
      "KC_TRNS",
      "KC_TRNS",
      "KC_TRNS",
      "KC_TRNS",
      "KC_TRNS",
      "KC_TRNS",
      "KC_TRNS",
      "KC_TRNS",
      "KC_NO",
      "KC_TRNS",
      "KC_TRNS",
      "KC_TRNS",
      "KC_TRNS",
      "KC_TRNS",
      "KC_TRNS",
      "KC_TRNS",
      "KC_TRNS",
      "KC_TRNS",
      "KC_TRNS",
      "KC_TRNS",
      "KC_NO",
      "KC_NO",
      "KC_TRNS",
      "KC_TRNS",
      "KC_TRNS",
      "KC_TRNS",
      "KC_TRNS",
      "KC_TRNS",
      "KC_TRNS",
      "KC_TRNS",
      "KC_TRNS",
      "KC_TRNS",
      "KC_TRNS",
      "KC_TRNS",
      "KC_TRNS",
      "KC_NO",
      "KC_TRNS",
      "KC_TRNS",
      "KC_TRNS",
      "KC_TRNS",
      "KC_TRNS",
      "KC_TRNS",
      "KC_TRNS",
      "KC_TRNS",
      "KC_TRNS",
      "KC_TRNS",
      "KC_TRNS",
      "KC_TRNS",
      "KC_TRNS",
      "KC_TRNS"
    ]
  ],
  "encoders": []
}